50, 143
371, 112, 21
356, 383, 39, 32
34, 59, 28, 26, 35
931, 141, 39, 46, 10, 49
609, 196, 19, 32, 15, 13, 50
170, 184, 35, 49, 33, 12, 33, 46
238, 54, 17, 29, 34, 13, 27, 21, 11
270, 199, 38, 44, 47, 16, 44, 22, 42, 31
736, 460, 18, 12, 11, 27, 23, 13, 32, 14, 50
646, 136, 27, 18, 23, 10, 49, 25, 21, 46, 35, 13
888, 575, 23, 22, 23, 38, 42, 21, 28, 36, 38, 15, 46